*** ***
*     *
*** * *
*   * *
* *** *
*     *
*** ***
